1	1	1	1	1	1	1	1	1	1	1	1	1	1
1	X1	0	0	0	0	0	0	0	0	0	0	X4	1
1	0	0	0	0	0	0	O	0	0	0	0	0	1
1	0	0	0	O	O	0	0	0	0	1	0	0	1
1	0	0	1	1	1	2	1	1	2	1	0	0	1
1	0	0	0	0	0	0	0	O	O	1	0	0	1
1	0	0	1	0	0	0	0	0	0	2	0	0	1
1	2	1	1	1	2	1	1	2	1	1	1	2	1
1	0	0	0	0	0	0	0	0	0	0	0	0	1
1	0	0	1	0	0	1	1	0	0	0	0	0	1
1	0	0	1	O	O	2	0	O	O	1	0	0	1
1	0	0	1	0	0	2	O	0	0	1	0	0	1
1	X2	0	0	0	0	0	0	0	0	0	0	X3	1
1	1	1	1	1	1	1	1	1	1	1	1	1	1