1	1	1	1	1	1	1	1	1	1	1	1	1	1
1	X1	0	0	0	0	0	0	0	0	0	0	X4	1
1	0	1	0	1	0	1	0	1	0	1	0	0	1
1	0	0	0	0	0	0	0	0	0	0	1	0	1
1	0	2	0	1	0	2	0	1	0	2	0	0	1
1	0	0	0	0	0	0	0	0	0	0	0	0	1
1	0	0	0	2	2	2	2	2	2	2	2	1	1
1	0	0	2	0	2	2	2	2	2	0	1	0	1
1	0	0	0	0	2	2	2	0	0	1	0	0	1
1	2	0	1	0	2	2	2	0	1	0	0	0	1
1	0	0	1	0	2	2	2	1	0	0	2	0	1
1	0	0	1	0	0	0	2	0	0	2	0	0	1
1	X2	0	1	0	0	0	0	0	0	0	0	X3	1
1	1	1	1	1	1	1	1	1	1	1	1	1	1