1	1	1	1	1	1	1	1	1	1
1	X1	0	0	0	0	0	0	X3	1
1	0	0	0	0	0	0	0	0	1
1	0	0	0	2	O	0	0	0	1
1	0	0	0	0	0	0	0	0	1
1	X4	0	0	0	0	0	0	X2	1
1	1	1	1	1	1	1	1	1	1