1	1	1	1	1	1	1	1	1	1	1
1	X1	0	0	0	0	0	0	0	X2 	1
1	0	0	0	0	0	0	0	0	0	1
1	0	0	0	0	0	0	0	0	0	1
1	0	0	0	0	0	0	0	0	0	1
1	0	0	0	0	0	0	0	0	0	1
1	0	0	0	0	0	0	0	0	0	1
1	0	0	0	0	0	0	0	0	0	1
1	0	0	0	0	0	0	0	0	0	1
1	X3	0	0	0	0	0	0	0	X4	1
1	1	1	1	1	1	1	1	1	1	1