1	1	1	1	1	1
1	X1	1	X2	0	1
1	0	1	1	0	1
1	0	1	0	0	1
1	0	X4	2	X3	1
1	1	1	1	1	1